11111
10P01
10101
1E011
11111
11C11
11111
