10111111
1000c01
100e101
10000p1
1111111
