111111
1C0001
100001
1000E1
1P0001
111111
