111111111111
10P010001111
1CCC10E01111
111CCC111111
1C000C001101
1000C0001101
111111111001
100000001001
111111111111
